----------------------------------------------------------------------------------------------------------------------------------------------------o------------------------------------------------------
-----------------------------------------------------------------------------------------------------------------------------------------------------------------------------------------------------------
------------------------------------------------------------------------------------------?----------------------------------------------------------------------------------------------------------------
-----------------------------------------------------------------------------------------------------------?-----------------------------------------------------------------------------------------------
-----------------------------------------------------------------------B-----------------------------------------------------------------------------------------------------------------------------------
-----------------------------------------------------------------------------------------------------------------------------------------------------------------------------------------------------------
-----------------------------------------------------------------------------------------------------------------------------------------------------M-----------------------------------------------------
-------------------------------------------------------------------------------------------------------------------------------------------------------------------------------------------------------v---
-------------T------------------------------------------------------------------------------------------------X----------X-----------------------------------------------------------------------------f---
------------o|------------------------------------------------------------------------------------------------X--------------------------M----------???------------------------------------------------f---
-------------|----------------------X-------------------------------------------------------------------------XX--------------------------------------------------------X------------------------------f---
-------------|---------------------XX-----------------------------------------------------o-------------------XXX------------------------------------------------------XX----------------------------?-f---
---------X---|--------------M-----XXX-----------------------------------------------------T-------------------XXXX----------------------------------------------------XXX------------------------------f---
--------XX---|--------T----------XXXX------B----------------------------------------------|-------------T-----XXXXX--------------------------------------------------XXXX------------------------------f---
m------XXX---|--------|---------XXXXX-----E---------------------------------------------E-|-------------|-----XXXXXX------------------------------------------------XXXXX------------------------------X---
XXXXXXXXXXXXX|XXXXXXXX|XXXXXXXXXXXXXXXXXXX--------XXXXXXXX--------XXXXXXXXXXXXXXXXXXXXXXXX|XXXX----XXXXX|XXXXXXXXXXXXXXXXXXXXXXXXXXXXXXXXXXXXXXXXXXX--------XXXXXXXXXXXXXXXXXXXXXXXXXXXXXXXXXXXXXXXXXXXXXXX
