-----------------------------------------------------------------------------------------------------------------------------------------------------------------------------------------------------------
-------------------BB---------------------------------------------------------B-------------------------------------------------X--------------------?-----------------------?-----------------------------
----------------------------------------------------------------------------------------------------------------------------------------------------------------------------------------M------------------
----------------------------------------------------------------------------------------------------------------------------------------------------------------M------------------------------------------
---------------------------------------------------------X-------------------------------------------------------------------------------------------------------------------------------------------------
--------------------------------------------------------XX--------------------------------------X---------------------------????--------------------------------?------------------------------------------
-------------------------------------------------------XXX-------------------------------------XX--------------------------------------------------------------------------------------------------T-------
------------------------------------------------------XXXX------------------------------------XXX--------------------------------------------------------------------------------------------------|---v---
-----------------------------------------------------XXXXX-----------------------------------XXXX---XXX-----------------------------------------T---------------------X----------------------------|---f---
---------------------------------o------------------XXXXXX----------------------------------XXXXX-----------------------------------------M-----|-----------o--------------------------------------|---f---
---------------------------------------------------XXXXXXX---------------------------------XXXXXX-----------------XXXXXXXX----------------------|-------X------------------------------------------|---f---
-----------------------------T--------------------XXXXXXXX--------------------------------XXXXXXX-----------------------------------------------|------XX--------------------------------X---------|---f---
-------------------B---------|-------------------XXXXXXXXX-------------------------------XXXXXXXX-----------------------------------------------|-----XXX-----------------------------------X------|---f---
-----------------------------|------------------XXXXXXXXXX-------------------T----------XXXXXXXXX-----------------------------------------------|----XXXX--------------X---------------------------|---f---
m----------------------------|-----------------XXXXXXXXXXX---E-E-------------|---------XXXXXXXXXXE------------B----------------E-----E---E------|---XXXXXE------------XX-----------------------E--E|---X---
XXXXXXXXXXXXXXXXXXXXXXXXXXXXX|XXXXXXXXXXXXXXXXXXXXXXXXXXXXXXXXXXXXXXXXXXXXXXX|XoXXXXXXXXXXXXXXXXXXXXXXXXXXXXXXXXXMXXXXXXXXXXXXXXXXXXXXXXXXXXXXXX|XXXXXXXXXXXXXXXXXXXXXXXXXXXXXXXXXXXXXXXXXXXX------|XXXXXXX
