-------------------------------------------------------------------------------------------------------------------------------BBBBBBB---------------------------------------------------------------------
--------------------------------------------------------------------o--------------------------------------------------------------------------------------------------------------------------------------
------------------------------------------------------------------------------------------o--------------------------------------------------------------B-------------------------------------------------
-----------------------------------------------------------------------------------------------------------------------------------------------------X-----------------------------------------------------
----------------------------------------------------------------------------------------------------------------------------------------T------------------------------------------------------------------
------------M----------------------------------------------------------------------?----------------------------------------------------|-------M-----------------------------o----------------------B-----
----------------------------------------------------------------------------------------------------------------------------------------|------------------------------------------------------------------
----------M----------------------------------------------------------------------------------------------B------------------------------|--------------------------------------------------------------v---
-----------------BBBBB------------------------------------------------------------------------------------------------------------------|--------------------------------------------------------------f---
--------------------------------------------------------------------o-----X----------------------------X--------------------------------|---------------------------B----------------------------------f---
-------------------------------------------------------------------------XX---------------------------XX------------T-------------------|-------------------------------T------------------------------f---
-----------------------------------------------------------------?---M--XXX--------------------------XXX------------|-------------------|-------------------------------|------------------------------f---
-----------------------------------------------------------------------XXXX-------------------------XXXX------------|-------------------|-------------------------------|-----------------BBBBBB-------f---
----------------------------------------------------------------------XXXXX------------------------XXXXX------------|-------------------|-------------------------------|---------------------------B--f---
m-----E----------------------------------M---E-----------------------XXXXXX-----------------------XXXXXX------------|----E--------------|--E-----------E-E---E---E-E----|-E----E-----------------------X---
XXXXXXXXXXXXXXXXXXXXXXXXXXXXXXX?XXXXXXXXXXXXXXXXXXXXXXXXXXXXXXXXXXXXXXXXXXX----XXXXXXXXXX-XXX--XXXXXXXXXXXXXXXXXXXXX|XXXXXXXXXXXX-------|XXXXXX--XXXXXXXXXXXXXXXXXXXXXXX|XXXXXXXXXXXXXXXXXXXXXXXXXXXXXXXXXX
