---------------------------------------------------------------------------------------------------------------------------------X-------------------------------------------------------------------------
-----------------------------------------X-----------------------------------------------------------------------------------------------------------------------------------------------------------------
-----------------------------------------------------------------------------------X-----------------------------------------------------------------------------------------------------------------------
---------------------------------------------------------------?-------------------------------------------------------------------------------------------------------------------------------------------
----------------------------------------------------------------------------------------o-----------------------------------------------------------------------------------------------------------X------
---------------X--------------------------------------------------------------------------------------------------------------------------X--------------------------------------------------------XX------
--------------XX----------------------------------------------------------------------------------------------------------------------------------------------------------------------------------XXX------
-------------XXX--------?------T-----------------------------------------------------------------------------------------------------------------------------------------------------------------XXXX--v---
------------XXXX---------------|-----B----------------------------------------------------------------------------------------------------------------------------------------------------------XXXXX--f---
-----------XXXXX---------------|----------------------------------------------------------------------------------------------------------------------------------------------------M----------XXXXXX--f---
----------XXXXXX---------------|---------------X-------------------------------------------------------------------------------------------------------------T--------------------------------XXXXXXX--f---
---------XXXXXXX---------------|---------------XX------------------------------------------------------------------------------------------------------------|-------------------------------XXXXXXXX--f---
--------XXXXXXXX---------------|---------------XXX-----------------------------------------------------------------------------------------------------------|------------------------------XXXXXXXXX--f---
-------XXXXXXXXX---------------|---------------XXXX----------------------------------------------------------------------------------------------------------|-----------------------------XXXXXXXXXX--f---
m-----XXXXXXXXXX----E----------|---------------XXXXX---------------------------------------------------------------EE----------------------------------------|-----------------------M----XXXXXXXXXXX--X---
XXXXXXXXXXXXXXXXXXXXXXXXXXXXXXX|XXXXXXXXXXXXXXXXXXXXXXXXXXXXXXXXXXXXXXX------XXXXXXXXXXXXXXXXXXXXXXXXX-------XXXXXXXX--------XXXXXXXXXXXXXXXXXXXXXXXXXXXXXXXX|XXXXXXXXXXXXXX-----XXXXXXXXXXXXXXXXXXXXXXXXXX
