-----------------------------------------------------------------------------------------------------------------------------------------------------------------------------------------------------------
-------------------------------------------------------------------------------------------------------------------------------------M---------------------------------------------------------------------
-----------------------------------------------------------------------------------------------------------------------------------------------------------------------------------------------------------
---------------------------------------------------------------------------------M-------------------------------------------------------------------------------------------------------------------------
----------------------------------------------------------------------------------------------------------------------XX-----------------------------------------------------------------------------------
--------------------------------------------------------------------------------------------------------------------T------------------------T-------------------------------------------------------B-----
--------------------------------------------------------------------------------------------------------------------|------------------------|-------------------------------------------------------------
------------------------------X-------------------------------------------------------------------------------------|------------------------|---------------------------------------------------------v---
-----------------------------XX---------------------------------------------------------------------------------X---|------------------------|---------------------------------------------------------f---
----------------------------XXX-----------------------------------------X--------------------------------------XX---|------------------------|---------------------------------------------------------f---
---------------------------XXXX----------------------------------------XX-------------------------------------XXX---|------------------------|------------------------------------XXXXXXXX-------------f---
--------------------------XXXXX---------------------------------------XXX------------------------------------XXXX---|------------------------|--------o------------------------------------------------f---
-------------------------XXXXXX--------------------------------------XXXX------------------o----------------XXXXX---|------------------------|---------------------------------------------------------f---
------------------------XXXXXXX--------------------------------X----XXXXX----------------------------------XXXXXX---|------------------------|---------------------------------------------------------f---
m----------------------XXXXXXXX-------------------------------XXXXXXXXXXX---------------------------------XXXXXXX-E-|------------------------|-------------------------------------------------------E-X---
XXXXXXXXXXXXXXXXXXXXXXXXXXXXXXXXXXXXXXXXXXXXXXXXXXXXXXXXXXXXXXXXXXXXXXXXXXXXXXXXXXXXoXXXXXXXXXXXXXXXXXXXXXXXXXXXXXXX|XXXXXXXXXXXXXXXXXXXXXXXX|XXXXXXXX----XXXXXXXXXXXXXXXXXXXXXXXXXXXXXXXXXXXXXXXXXXXXXXXXX
