----------------------------------------------------------------------------------------X-----------------------------------------??????-------------------------------------------------------------------
-------------------------------------------------------------------------------------------------------------------------------------------------------------o------------------------?--------------------
-----------------------------------------------------------------------------------------------------------------------------------------------------------------------------------------------------------
-----------------------------------------------------------------------------------------------------------------------------------------------------------------------------------------------------------
----------------------------------------BBBBB-----------------------------------------------------------------------------------------------------------------o--------------------------------------------
---------------------------------------------------------------------------------------------o-------------------------------------------------------------------------------------------------------------
------------------------------------------------------------------------------------------------------------------------------------------------------------------------------T----------------------------
----------------------------------------------------------------B-----------------------M-------o-------------------------------------------------o---------------------------|------------------------v---
------------------------------------------------------------------------------------------------------------------------------------------------------------------------------|------------------------f---
------------------------------------------------------------------------------M-------------------X---------------------------------------------------------------------------|------------------------f---
------------------------------------X------------------------o-----------------------------------XX---------------------------------------------------------------------------|------------------------f---
------------------------------------XX----------------------------------------------------------XXX---------------------------------------------------------------------------|------------------------f---
------------------------------------XXX-----------------------------T--------------------------XXXX---------------------------------------------------------------------------|------------------------f---
-----------------------------------XXXXX----------------------------|-------------------------XXXXX---------------------------------------------------------BBBBBBB-----------|------------------------f---
m--------------------------E------XXXXXXX---------------------------|-------------E----------XXXXXX---------------------------------------------------------------------------|-------------E----------X---
XXXXXXXXXXXXXXXXXXXXXXXXXXXXXXXXXXXXXXXXXXXXXXXXXXXXXXXXXXXXXXXXXXXX|XXXXXXXXXXXXXXXXXXXXXXXXXXXXXX----XXXXXXXXXXXXXXXXXXXXXXXXXXXXXXXXXXXXXXXXXXXXXXXXXXXXXXXXXXXXXXXXXXXXXXX|XXXXXXXX-----XXXXXXXXXXXXXXX
