--------------------------------------------------------------------------------------------------------------------------------------------------------------------------------------------------?????----
-----------------------------------------------------------------------------------------------------------------------------------------------------------------------------------------------------------
-----------------------------------------------------------------------------------------------------------------------------------------------------------------------------------------------------------
----------------------------------------------------------------------------------------------------------------------------------------------------------------------------------------T------------------
-----------------------------------------------------------------------------------------------------------------------------------------------------X----------------------------------|----------M-------
--------------------------------------------XXXXX---------------------------------------------------------------------------------------------------------------------------------------|------------------
--------------------------------X---------------------------------------------------------------------------------------------------------------X---------------------------------------|------------------
-------------------------------XX--------------------------------------------------------------------????????-------????????------------------------------------------------------------|--------------v---
------------------------------XXX-------------------------------------------------------------------------------------------------------------------------------------------------------|-T------------f---
-----------------------------XXXX-------------------------------------------------------------------------------------------T-----------------------------------------------------------|-|------------f---
----------------------------XXXXX-------------------------------------------------------------------------------------------|-----------------------------------------------------------|-|------------f---
---------------------------XXXXXX-----------B-------------------------------------------------------------------------------|-------------------------------------T---------------------|-|------------f---
--------------------------XXXXXXX-------------------------------------------------------------------------------------------|-------------------------------------|---------------------|-|------------f---
-------------------------XXXXXXXX------------------------------------------------------------------------------------------?|??????-------------------------------|---------------------|-|------------f---
m-----------------------XXXXXXXXX-------------------------------------------------------------------------------------------|-------------------------------------|---------------------|-|------------X---
XXXXXXXXXXXXXXXXXXXXXXXXXXXXXXXXXXXXX-XXXXXXXXXXXXXXXXXXXXXXXXXXXXXXXXXXXXXXXXXXXXXXXXXXXXXXXXXXXXXXXXXXXXXXXXXXXXXXXXXXXXXX|XXXXXXXXXXXXXXXXXXXXXXXXXXXXXXXXXXXXX|XXXXXXXXXXXXXXXXXXXXX|X|XXXXXXXXXXXXXXXX
