-----------------------------------------------------------------------------------------------------------------------------------------------------------------------------------------------------------
--------------------------------------------------------------------------------------------------------------B--------------------------------------------------------------------------------------------
--------------M-----------------------------------------------------M--------------------------------------------------------------------------------------------------------------------------------------
-------------------------------------------------------------------------------------------X---------------------------------------------------------------------------------------------------------------
------------------------------------X-----------------------------------------------------------------------------------------------------------------------------------------------?----------------------
-----------------------------------XX------------------------------------------------------------------------------?----------------------------------??????-----------------------------------------------
----------------?-----------------XXX---------------------?------------------------------------------------------XXXXXX------------------------------------------------------------------------------------
---------------------------------XXXX--------------------------------------------------------------------------------------------------------------------------------------------------------o---------v---
--------------------------------XXXXX--------------------------------T--------------------------------------------------------------------------????????-----X-----------------------------------------f---
-------------------------------XXXXXX--------------------------------|-------------------------------------------o------------------------------------------XX-----------------------------------------f---
-------------------------?----XXXXXXX------------------------B-------|-----------T--------------X----------------------------------------------------------XXX-----------------------------------------f---
-----------------------------XXXXXXXX--------------------------------|-----------|-------------XX---B----M-----------------------------------------------XXXXX-----------------------------------------f---
------------------T---------XXXXXXXXX----------------X---------------|-----------|------T-----XXX------------------------X----------------BBBBBB---------XXXXX-----------------------------------------f---
---------T--------|--------XXXXXXXXXX---------------XX---------------|-----------|------|----XXXX-------------------------------------------------------XXXXXX-----------------------------------------f---
m---E---X|--------|-------XXXXXXXXXXX--------------XXX---------------|-----------|------|---XXXXX--------------------------------------------------E---XXXXXXX----------------------E------------------X---
XXXXXXXXX|-----XXX|XXXXXXXXXXXXXXXXXXXXXXXXXXXXXXXXXXXXXXXXXXXXXXXXXX|XXXXXXXXXXX|XXXXXX|XXXXXXXXXXXX------XXXXXXXXXXX--XXXXXXXXXXXXXXXXXXXXXXXXXXXXXXXXXXXXXXXXXXXXXXXXXXXXXXXXXXXXXXXXXXXXXXXXXXXXXXXXXXX
