-----------------------------------------------------------------------------------------------------------------------------------------------------------------------------------------------------------
-----------------------------------------------------------------------------------------------------------------------------------------------------------------------------------------------------------
------------------------------------------------------------------------------------------------------------------------------------------------------------------------------------------------------B----
-?--------------------------------------------------B----?-------------------------------------------------------------------------------------------------------------------------------------------------
-----o------------------------------------------------------------------------------------------------------------------------------------------------------------------------------------T----------------
----------------------------------------------------------------------------------------------------------------------------------------------------------------------------------------M-|----------------
---------------------------------------------------------------M--------------------------------------------------------------------------------------------------------------------???---|----------------
-------------------------XXXXXXXX---------------------------------------------------------------------------------------------o-----------------------------------------------------------|------------v---
-----------------------------------------------------------------------------------------X----------------------------------------------------T-------------------------------------------|------------f---
-----------------------------------o----------------------------------------------------XX----------------------------------------------------|------------M------------------------------|------------f---
-----------------------------o---------------------------------------------------------XXX---T-----------------------o------------------------|-------------------------------------------|------------f---
--------------------T-----------------------------------------------------------------XXXX---|------------------------------------------------|-------------------------------------------|------------f---
-----------------X--|----------------------------------------------------------------XXXXX---|-----------------????????-----------------------|-------------------------------------------|------------f---
--------------------|--------------------------------------------------------XT-----XXXXXX---|------------------------------------------------|--------------------------------------o----|------------f---
m------E------------|-------E-M----E------E-------o----------X--X-------------|----XXXXXXX---|------------------------------------------------|E------------------------------E-E---------|------------X---
XXXXXXXXXXXXXXXXXXXX|XXXXXXX-------XXXXXXXXXXXXXXXX-XXXXXXXXXXXXXXXXXXXX?????X|XXXXXXXXXXXXXX|XXXXXXXXXXXXXXXXXXXXXXXXXXXXXXXXXXXXXXXXXXXXXXXX|XXXXXX--XXXXXXXXXXXXXXXXXXXXXXXXXXXXXXXX?XX|XXXXX-------XXXX
