-----------------------------------------------------------------------------------------------------------------------------------------------------------------------------------------------------------
-------------------------------------------------------------------------------------------------------------------------------------------------------BBBBBB----------------------------------------------
---------------------------------------------------------------------------------------------------------------------------------o------------------X------------------------------------------------------
-----------------------------------------------------------------------------------------------------------------------------------------------------------------------------------------------------------
------------------------------------------------------------------------------------------------------------------------------X----------------------------------------------------------------------------
-------------------------------------------------------------------------------------------------------------------------X------------------------------o--------------------------------------------------
-----------------------------------------------------------------------------------------------------------------------------------------------------------------------------------------------------------
--------------------------------------------------------------------------------------------------------------------------------------------------------------X----------------M-----------------------v---
-------------------------------------------------------------------------------------------------------------------------------------------------------------XX----------------------------------------f---
----------------------------------------X-------------------------------------------------------------T-----------------------------------------------------XXX-------------------------------------B--f---
------------------------------------------------------------------------------------------------------|----------------------------------------------------XXXX----------------------------------------f---
-------------------------------------------------------------------------------------------XXXXXX-----|---------------------------------------------------XXXXX----------------------------------------f---
------------------------------------------------------------------------------------------------------|--------------------------------------------------XXXXXX----------------------------------------f---
-----------------------------------------------------------------------------------------------------B|-------------------------------------------------XXXXXXX------------T-------------------------?-f---
m---------------------------------------------------------E-------------------------------------------|------------------------E-----------------------XXXXXXXX------------|-E-------------------------X---
XXXXXXXXXXXXXXXXXXXXXXXXXXXXXXXXXXXXXXXXXXXXXXXXXX-------XXXXXXXXX--XXXXXXX?XXXXXXXXXXXXXXXXXXXoXXXXXX|XXXXXXXXX--------XXXXXXXXXXXXXXXXX----XXX---XXXXXXXXXXXX-X---XXXXXXX|XXXXX---XXXXXXXXXXXXXXXXXXXXXXX
